+//+++//+
+++/+/+++
/+++-+++/
+++/+/+++
+//+++//+
Record: 0